die Art - gatunek, rodzaj, sposób
der Arzt / die Ärztin - lekarz / lekarka
auch - te¿, tak¿e
auf - na
auf Wiedersehen - do widzenia, do zobaczenia
die Aufgabe - zadanie
das Auge - oko
der August - sierpieñ
der Ausgang - wyjœcie
ausgezeichnet - znakomity, wyborny
außer - oprócz
äußerst - nadzwyczaj, skrajnie
auswendig - na pamiêæ
das Auto - samochód, auto
Auto fahren - prowadziæ samochód
das Baby / der Säugling - niemowlê
backen - piec (np. ciasto, chleb)
der Bäcker - piekarz
die Bäckerei - piekarnia
das Bad - k¹piel; ³azienka; ³aŸnia; p³ywalnia; uzdrowisko
das Badezimmer - ³azienka
der Bahnhof - dworzec kolejowy
bald - wkrótce, zaraz, niebawem
der Balkon - balkon
der Ball - pi³ka, bal (zabawa taneczna)
die Banane - banan
die Bank (³awka) - ³awka
die Bank (instytucja) - bank
die Banknote - banknot
bar - gotówk¹
die Bar - bar (lokal)
der Bär - niedŸwiedŸ, miœ
der Bart - broda
der Bauernhof - gospodarstwo rolne, zagroda (ch³opska)
der Baum - drzewo
bedeuten - znaczyæ, oznaczaæ
beenden - skoñczyæ, zakoñczyæ
beginnen - zacz¹æ (siê)
beide - obaj, obie, oboje
das Bein - noga, koœæ
das Beispiel - przyk³ad
bekommen - dostaæ, otrzymywaæ
das Benzin - benzyna (pot. paliwo)
bereit - gotowy
der Berg - góra
berühren - dotykaæ
der Besen - miot³a
besser - lepiej
bester, beste, bestes - najlepszy, najlepsza, najlepsze
besuchen - odwiedzaæ, uczêszczaæ (do szko³y)
beten - modliæ siê
betrachten - przygl¹daæ siê, ogl¹daæ, traktowaæ/poczytywaæ (jako)
beträchtlich - znaczny, pokaŸny
betrunken - pijany
das Bett - ³ó¿ko
bewegen - poruszaæ, wprawiaæ w ruch
bewegen (emocjonalnie) - poruszyæ, poruszaæ
die Biene - pszczo³a
das Bier - piwo
das Bild - obraz, obrazek, ilustracja, fotografia
